
ba=鼥釛軷釟蚆弝抜朳覇胈豝癹矲壩菝犮鲅仈罷魃岜茇笆钯粑耙跋灞叭捌靶疤芭扒坝霸罢拔巴爸八把吧
bai=竡拝擘粨栢粺捭擺敗稗挀伯佰呗掰柏败拜摆百白
ban=斒魬螁靽鉡怑鈑昄姅柈蝂絆舨頒粄湴闆癍攽瘢钣辦阪坂颁扳绊瓣拌扮斑伴搬般板班半版办
bang=峀艕玤縍搒鎊鞤塝謗蒡旁綁垹幇梆幫膀谤蚌镑傍磅绑浜邦榜棒帮
bao=飹忁髱鳵駂靤怉齙炮虣鴇鑤媬珤蕔窇笣趵瀑褓儤鮑龅鸨剥飽刨寳菢報雹勹寶孢宀葆褒苞曝胞豹煲鲍堡薄饱暴爆保抱宝报包
ben=栟泍錛夯坌畚犇渀贲锛苯奔笨本
beng=閍嵭塴菶琫埲祊甏伻繃蚌嘣迸绷甭崩蹦泵
bei=犕鵯鄁糒藣骳梖狽襬憊桮鞁揹鋇誖椑庳鐾牬琲鞴褙鹎邶珼偝輩盃碚貝臂狈唄孛備陂悖钡惫焙蓓辈卑碑悲备贝杯倍背北呗被
bi=滭驆鷝馝梐鼊鷩鵖鮅飶襣鄨奰蜌朼駜罼疕熚貏蓽贔腷廦獘鏎篳坒髲鄪怭幤愊縪舭匂蹕閇綼珌潷秘觱皕嗶痺邲沘獙庳粊賁柀狴詖疪荸閟贲睥躄斃萆堛幣筚愎泌嬶跸佖箅裨閉繴襞彃苾秕畢毖妼髀嬖芘蓖楅湢筆篦薜妣哔濞匕铋荜陛滗婢吡鄙庇敝痹弼蔽辟毙璧畀屄弊臂彼闭鼻避壁毕碧俾币逼笔必比
bian=鴘稨汳峅甂惼豍艑揙萹辧髟辮籩窆缏碥箯抃貶鳊邉蝙辯忭笾褊釆変砭編汴邊苄變弁煸匾辫卞贬辨鞭辩扁编遍变边便
biao=鰾飇臕瀌髟墂爂贆檦滮猋瘭鏢熛鑣驃褾藨諘儦飆鳔錶俵摽飑標灬杓镳骠婊裱膘镖飚飙彪标表
bie=蛂徶襒虌鼈癟柲蟞咇鱉彆蹩別瘪鳖憋别
bin=鑌霦髕椕虨臏濵擯蠙瀕繽鬢濱邠儐傧賓髌豳膑玢摈殯槟缤殡濒镔鬓滨宾彬斌
bing=栟鋲蛃鞆庰怲窉陃誁苪檳梹寎竝餠棅倂垪稟抦掤偋昺鞞併槟餅屏邴幷摒氷禀並秉炳柄丙饼兵冰病并
bo=鵓鱍挬郣餑蹳餺鑮鉑胉葧鋍瓝欂懪秡糪鉢襮犦鈸僠譒簙詙蔔狛蘗嶓駮鹁駁饽缽檗愽鎛踣浡孛礡魄礴剝僰擘簸钹撥亳菠箔跛舶渤帛癶铂脖玻钵卜驳膊泊勃柏搏剥啵薄伯拨播博波
bu=轐篰峬踄誧蔀醭餔鈽鳪鸔咘钸晡瓿埔佈堡歩逋補钚怖哺吥卟埠簿捕卜步布补部不

pa=汃跁舥鈀袙钯筢帊杷掱葩琶耙扒啪趴帕爬怕
pai=箄鎃犤簰棑蒎迫俳徘湃哌牌排派拍
pan=瀊坢縏蒰碆蹣沜眅詊褩頖溿跘鞶牓磻蹒拚籓襻幋槃媻牉袢盤丬爿胖蟠泮番磐叛畔攀盼判潘盘
pang=舽夆徬汸龐耪雱尨螃磅膀嗙彷乓逄滂庞旁胖
pao=颮穮麭蚫奅皰鞄袌鉋垉麃萢瓟脬砲嚗炰褜匏狍脟拋咆庖疱刨袍炮抛泡跑
pen=翸葐歕翉呠衯湓噴盆喷
peng=皏樥駍掽鑝閛恲憉髼篣軯搒鬅痭匉韸漰熢錋輣絣摓磞剻傰蟛弸鵬抨怦堋踫椪芃嘭篷膨砰澎硼烹蓬棚朋捧鹏彭碰
pei=怌毰陫裵琣茷柸蓜轡浿俖锫衃賠伂帔姵旆醅霈辔珮胚沛呸裴佩培赔配陪
pi=銢魾髬否螷鷿礔銔蠯揊箆豼秠鵧狉稫猈粃駓鈲岯蚽錍鴄膍阰蚾憵鈚羆諀鎞毞闢澼睥疋紕貔蚍埤陴毘笓伓纰郫砒庀裨枇甓淠仳鈹鼙崥媲伾罴嚭蜱琵霹陂邳铍圮噼譬僻毗啤丕痞疲辟坯癖匹劈脾披屁批皮
pian=鶣騈駢貵骿猵跰媥璸緶諚諞楩犏蹁楄胼扁騙谝骈翩便偏骗篇片
piao=犥旚蔈篻驫皫醥魒翲彯顠慓髟縹莩飃僄謤薸骠螵嘌飄殍缥剽瓢瞟嫖朴漂飘票
pie=覕暼潎嫳氕苤丿瞥撇
pin=礗驞砏顰矉玭嚬貧頻榀蘋嬪牝拚姘颦嫔聘贫频拼品
ping=涄竮塀艵郱甹蛢缾鮃輧淜荓鉼軿頩蓱玶砯岼屛泙洴甁俜帡倗評憑鲆呯枰乒娉苹坪萍屏瓶评凭平
po=烞鏺釙馞猼岶蒪翍溌繁濼醱岥謈髆尃桲哱钷昢笸朴櫇潑搫泺頗钋陂鄱叵皤粕攴珀泊巿魄迫泼婆颇坡破
pou=捊襃垺裒棓掊婄抔剖
pu=瞨鏷獛烳駇痡鯆鵏舗抪蒱襆镤潽墣酺暴鐠僕舖樸鋪纀譜匍镨氆撲蹼堡脯菩莆曝溥埔濮圃璞葡仆瀑噗朴蒲浦谱扑铺普

m=呣嘸呒
ma=礣榪溤鷌蟇鬕痳螞禡摩犘痲嬤嘜傌犸鎷孖瑪碼蚂蟆杩罵麽媽么馬抹嗎玛麻码骂妈马嘛吗
mai=鷶嘪霢勱邁荬脈売麥賣買霾唛劢脉迈埋麦卖买
man=鞔鬗饅屘蟃樠鰻矕蘰獌慲謾睌瞞縵僈埋镘墁姏鏝顢颟鬘缦嫚馒谩蠻滿鳗幔熳螨蔓瞒漫曼蛮满慢
mang=壾蛖痝娏蘉龒杗哤蠎駹汒硥牻鋩硭邙笀漭厖氓蟒茫莽芒盲忙
mao=鶜蝐渵毷枆軞鉚蓩酕錨皃冐犛媢貿鄮眊鄚芼楙蝥秏氂瞀蟊泖袤牦耄髦峁瑁茆旄昴貓铆懋锚卯贸貌矛茅帽茂冒冇猫毛
me=嚜麼麽么
men=虋椚懣璊捫殙燜鍆菛钔暪鞔亹懑悶悗満扪門們焖闷门们
meng=瓾霥鸏氋鄸蕄饛錳庬罞鄳甿鋂萠幪懞艨矇鼆儚氓曚蜢艋礞瞢甍蠓虻濛勐朦夢檬懵锰萌盟孟蒙猛梦
mei=攗堳塺蝞腜栂躾蘪燘挴徾痗瑂黴禖猸楳苺镅眛郿煝鹛糜渼媄鎂毎媺脢嵋沬浼楣袂莓湄寐昧魅沒镁玫媒霉媚枚酶眉煤妹梅美每没
mi=鸍麊塓熐蝆獼葞羃樒醾滵銤峚漞幦麛榓覛鼏蔝蔤爢渳灖蓂冞穈謐瀰羋幎祕猕瞇敉覓縻彌謎尒冪櫁汩脒麋嘧汨芈弭谧蘼泌宓幂祢糸尓醚糜靡眯觅弥谜秘蜜咪密迷米
mian=麪葂靦蝒矏緜愐矊麺櫋渑鮸媔偭喕丏湎綿緬俛娩麵腼沔婂眄冕勉缅绵眠棉免面
miao=鱙篎竗媌訬緲嫹廟杪眇鹋缈藐邈缪渺淼描瞄喵庙妙苗秒
mie=鱴薎幭衊懱蠛搣篾滅蔑乜灭咩
min=簢痻刡怋琝錉蠠鈱罠黽暋僶鳘閩緡敯潣閔苠崏旼湣笢黾玟缗愍敃憫悯岷皿泯旻抿珉闽闵敏民
ming=慏鄍嫇榠覭蓂眳詺掵姳鳴銘酩洺瞑暝螟溟茗冥铭鸣命明名
miu=謬繆谬缪
mo=嘿髍爅絈塻蛨蟔瞙饃瀎狢暯糢袹纆驀嗼藦枺劘瘼粖眽絔麿謨万歿攠冒靺黙镆秣莈貊貘妺鏌嬷耱嫫么蓦脉寞殁蘑銆谟麽摹茉馍漠陌沫没默摩抹墨模磨膜末魔摸莫
mou=鴾麰鉾洠缪蛑鍪謀侔哞牟眸谋某
mu=慔畆姥艒鞪蚞氁峔砪楘炑鉧萺凩毣獏茻鉬踇縸幙毪牳莯霂坶仫畝呒苜模拇牟牡睦钼募沐暮幕牧慕姆墓穆亩目母木

fa=藅疺罸瞂醗沷琺閥砝髪罰発垡髮珐筏發乏阀罚伐法发
fan=鷭鱕滼橎颿旙舩嬏羳笲蠜軬払瀪飜鐇杋釩奿礬膰軓轓笵籵瀿薠旛繙蹯氾汎柉仮販辺墦範燔蘩璠煩犭畈飯勫矾攵幡蕃钒藩梵贩帆樊繁泛番犯返范凡翻烦反饭
fang=鶭髣錺淓瓬魴昞鈁邡紡钫訪倣彷鲂肪昉枋妨舫纺访仿坊芳防房方放
fen=秎鐼竕饙黂炃鼖羒鳻梤橨幩膹弅魵轒翂豶黺坋羵鈖雰妢蕡僨枌奮蒶憤糞昐紛棼棻蚡墳玢偾鲼濆吩瀵鼢氛忿汾焚纷愤酚奋坟粪芬粉份分
feng=飌艂焨甮捀凬麷猦桻妦堸覂犎渢檒唪灃諷縫峯崶偑馮鋒豐楓酆賵瘋葑鳳砜俸風讽沣烽蜂奉缝逢枫锋丰凤冯疯峰封风
fei=鼣胇疿昲餥濷鯡襏曊蟦奜騛裶蜰廃騑厞暃屝誹鲱婓剕癈怫馡櫠緋棐榧悱廢篚镄狒芾蜚淝俷痱費诽腓鐨飛啡扉吠霏翡沸绯斐匪妃肺废菲肥费飞非
fiao=覅
fo=坲仏佛
fou=鴀缹紑缶否
fu=鴔翇糐畉蛗嬔邞艀鳬柫鶝韍荴玸踾郙蜅鰒烰弣髴蕧澓蚥釡賻萉罦紼笰怤葍柭鳧萯椨鮒岪蚹輹綒琈訃坿麩砆虙刜荂緮咈榑垘衭泭柎莩蝜枎鳆箙彿紨輻紱袚怫偪冹鈇蜉蚨駙枹簠芾帗祔艴姇偩菔砩縛郛複稃膚鄜伕綍諨幞婦趺袱撫茯桴鵩跗鲋驸茀蝮負绋绂匐賦洑黼輔拊赙鍑咐罘芣滏黻冨褔讣頫呋復麸脯祓涪苻凫蝠俘辐腑孵釜佛馥孚缚俯阜斧肤芙氟拂腐抚辅覆妇甫弗赋敷伏腹幅浮扶傅符附父府赴复夫负富福服付副

duan=碫躖媏籪腶毈葮簖偳緞鍛斷煅椴缎锻端断短段
dun=驐壿撉镦躉遯鈍不楯潡砘燉噸伅礅鐓頓惇沌囤趸盹遁钝墩敦蹲炖盾顿吨
da=畣鎝匒韃繨羍燵薘鐽躂炟咑靼褡龘噠瘩笪耷鞑沓達怛妲嗒哒搭答达大打
dai=艜軩靆獃紿柋襶軑瀻貸帯汏呔绐迨玳埭傣殆怠帶歹甙大岱逮黛贷袋戴呆代待带
dan=衴霮黕鴠沊髧刐澸鄲癚贉聸甔砃嚪狚燀匰禫觛譂玬蜑酖襌柦瘅萏亻褝簞憺憚啿泹啗誕殫疸紞郸石赕帎擔噉眈窞膽聃箪勯亶殚惮單儋澹掸卩耽啖诞旦氮弹担胆淡丹蛋单但
dang=瓽艡碭澢蟷礑璗襠鐺盪讜簹璫菪蕩儅擋噹谠砀黨凼檔宕铛裆當荡挡档党当
dao=隯陦隝釖幬嶹壔擣禂舠帱嶌翿搗裯禱焘捯椡魛儔稲檤盜嶋導菿氘瓙忉纛島祷刂蹈叨槝屶悼捣稻盗导岛刀倒道到

de=淂悳徳底锝德地得的
den=扥扽
deng=璒嬁墱豋簦戥嶝鐙鄧磴燈镫澄噔凳蹬瞪邓登灯等
dei=得
di=梊甋弤焍蹢靮軧眱髢梑逓鸐藡馰鏑蔋釱隄廸呧阺蔕嚁菧彽糴踶螮苖墑締蚳玓牴禘羝厎提遞滌奀諦磾坻袛鞮墬聜俤敵籴柢碲诋翟觌镝砥菂氐缔嫡棣骶旳邸涤荻嘀娣谛笛堤狄蒂递抵敌弟迪的帝睇底滴低第地
dia=嗲
dian=婝齻驔蕇澱椣阽蹎巓婰壂蒧巔扂瘨癲墊磹傎厧顛坫槙敁電玷惦钿簟癜佃奠巅淀靛踮丶癫點甸滇碘掂颠典垫殿电店点
diao=窵奝簓雿殦虭鵰蓧彫琱铫鯛蛁魡伄弴釣铞鸟碉鲷弔貂凋刁屌雕钓叼调吊掉
die=跮苵镻眣疉畳蜨嵽胅艓絰峌咥詄昳疂瓞諜蹀疊垤鲽堞耋喋褋牒谍迭叠蝶爹碟跌
ding=甼碠薡靪飣聢虰椗顁嵿帄錠掟萣耵疔訂釘仃玎酊碇啶頂腚町叮锭钉鼎盯订丁顶定
diu=銩颩铥丟丢
dou=瞗梪餖浢酘唗郖读鬪荳鈄竇蚪闘篼枓钭鬥脰蔸痘陡窦兜抖逗豆斗都
dong=鶫駧霘鶇鼕埬菄揰鮗蕫迵嬞挏苳涷諌働蝀姛崠胨戙岽凍鸫垌棟胴恫硐峒夂侗動東氡咚冻栋冬董洞东懂动
du=錖韇醏黷裻韣皾韥贕蠧詫讟櫝蝳帾犢妬覩瀆髑秺鍍読黩涜芏椟篤牘賭牍殰顿獨蠹讀渎犊妒笃睹镀嘟督肚渡堵赌独杜毒都度读
duo=鵽鬌鮵椯鈬綞毲嶞趓奲敪嚲痑剫陊柮杕錞鐸跢墯度裰沲躱驮朶墮奪柁咄埵敓哚掇惰剟垛舵踱跺铎哆剁堕朵夺躲多
dui=頧祋痽鴭瀩譈薱濧懟搥憝镦兌怼敦対隊碓兑對堆队对

tuan=鷻鷒猯貒糰墥慱煓褖槫団彖抟疃團鏄湍团
tun=飩錪芚蜳軘畽坉庉魨焞褪呑饨暾氽豚囤臀屯吞
ta=錔闒鞜鎉榙涾毾鞈澾鰨獺闥濌嗒嚃禢鞳誻鉈搨逹荅撘咜漯拓撻鳎趿遝遢溻褟闼獭挞铊蹋榻牠沓祂塌踏塔它她他
tai=鮐籉箈燤坮嬯溙斄颱鈶咍擡鈦炱儓檯鲐態臺跆呔薹酞骀邰汰肽苔钛态胎抬泰台太
tan=罎暺榃顃婒舕鉭憛黮貚裧藫賧繵嗿餤埮嘾撣譠罈醰癉壜儃曇菼癱灘锬僋醓歎忐怹憳潬惔壇譚嘆倓攤弾貪傝彈湠袒郯覃坍澹談钽昙毯瘫檀炭滩潭痰碳坦摊叹坛贪谭探弹谈
tang=鼞闣曭鶶薚鐋闛磄閶嵣蓎戃橖逿攩漡蘯矘漟鎕赯榶愓簜鏜踼摥煻惝蝪钂儻螗爣羰鎲燙帑醣蹚铴螳耥傥欓瑭樘搪湯镗溏膛倘淌棠塘烫躺趟糖堂唐汤
tao=錭蜪駣鞀鋾叨縚醄騊絛燾槄搯幍迯梼檮嫍慆韜匋綯鼗濤啕祹討弢饕萄洮焘绦夲滔韬掏淘桃讨涛陶逃套
te=鋱蟘貣铽慝忑忒特
teng=霯邆熥籘謄籐縢螣騰痋誊滕藤腾疼
tei=忒
ti=鷈銻褅蕛謕磃鬄瓋鷤鵜屜鶙嵜戻楴揥蝭趧姼徲鯷騠鶗籊迖裼綈啑悐徥珶緹詆躰惿渧稊荑軆殢褆薙洟偍崹绨逖厗嚏醍俶鹈扌題倜悌惕體屉鍗锑涕缇剔啼蹄剃梯替踢题体提
tian=鷏睼鷆靦顚痶磌鴫捵餂賟淟碵闐酟鈿窴琠菾婖舑沺緂甛晪悿屇搷佃湉畠畋倎掭腆殄畑阗忝钿恬舔甜添填田天
tiao=齠祒窱芀朷鎥鰷趒絩咷嬥蓚覜鯈鞗糶誂蓨岧宨脁鲦髫笤祧朓儵龆粜窕佻蜩迢庣調條苕眺挑调跳条
tie=驖鴩蛈惵揲鉆怗鋨呫僣鐡餮鐵萜貼铁帖贴
ting=圢鼮蝏烶嵉鋌頲楟濎烴榳桯艼娗聤珵廰諪筳庁渟聴綎珽侹莛廳脡铤閮町蜓葶梃聽烃霆艇汀廷婷亭庭厅停挺听
tou=埱斢紏敨黈蘣鍮妵偸钭骰頭透偷投头
tong=餇蓪鉖狪鮦氃膧衕犝絧爞慟詷朣湩痌哃橦浵囲烔樋粡曈銅垌茼峒炵統偅僮嗵侗恸仝潼砼酮佟彤瞳桐捅筒统桶童铜痛通同
tu=鷋鵵鶟釷鷵鼵鵌嶀筡鵚峹梌涋駼嵞捸廜跿汢唋蒤稌葖腯鋀瘏捈禿莵瑹湥酴兎図堍塗鍎钍菟圖荼秃屠途凸徒突兔涂吐土图
tuo=魠堶岮毻籜袉碢毤鴕沰鼉楕莌驒橢跅紽嫷嘽騨駄飥駝侻鮀託馱蟺酡跎魄鼍侂柝柁鸵箨椭橐脫铊乇庹佗唾沱砣驮驼坨妥陀拓脱拖托
tui=駾怢蹪橔藬頽弚僓隤穨蓷魋頹騩俀煺蜕颓忒褪腿推退

n=唔嗯
nuan=餪渜奻暖
nue=瘧疟虐
nv=聏衂朒恧釹衄籹钕女
na=豽軜貀魶秅笝鈉靹镎雫肭拏納衲捺钠呐娜纳哪拿那
nai=錼耏釢孻渿廼佴褦迺艿倷柰鼐氖萘奈耐奶乃
nan=揇抩萳遖婻戁妠暔諵嫨枏湳娚莮蝻赧柟囝腩難囡楠喃南难男
nang=鬞灢齉嚢擃攮涳曩馕囔囊
nao=獿峱鐃碯嶩碙蟯撓夒臑惱硇蛲閙嫐婥悩猱垴脳腦铙鬧淖呶瑙孬恼挠脑闹
ne=眲訥吶讷呐哪呢
nen=恁嫩
neng=螚能
nei=腇氝餒哪馁內那内
ni=淣籾濔屔臡觬秜跜堄鈮眤蜺狔鯢郳抳馜婗誽薿縌麑檷惄晲柅苨嫟迡暱隬貎齯灄擬膩猊嬭伲怩鲵児坭旎铌睨袮溺霓匿昵倪逆腻妮妳泥呢尼拟你
nian=躎秊簐攆鯰跈輦蹍鮎哖撚姩埝鲶鲇辗辇卄唸拈撵蔫碾黏捻廿粘念年
niao=樢嬝裊嫋蔦褭茑鳥溺袅脲嬲尿鸟
niang=醸釀嬢孃酿娘
nie=顳闑嶭鑈篞踗踙隉糱蠥孼踂峊嵲臲巕櫱躡齧嚙囓苶讘陧敜摄聶摰鎳鑷臬镊蹑蘖嗫啮颞乜孽镍涅聂捏
nin=拰您
ning=鸋鑏濘獰薴嬣聹嚀寍檸聍擰儜侫寗泞苧狞寧咛佞甯柠拧凝宁
niu=炄杻怓紐鈕狃忸拗钮纽扭妞牛
nou=羺鎒譨耨
nong=齈繷醲噥穠襛膿儂農濃哝脓浓侬农弄
nu=駑笯砮帑孥胬驽弩努奴怒
nuo=橠逽袲糑懧梛儺娜搦锘諾懦傩糯喏挪诺

luan=癵曫奱圞孿孌臠羉灤巒攣脔鑾鸞欒娈孪挛滦亂銮峦鸾栾卵乱
lue=鋝畧锊掠略
lun=陯踚碖溣菕蜦錀睔圇掄棆稐淪侖惀崙囵崘輪倫綸論沦抡仑纶伦轮论
lv=穭鷜鑢祣郘瘻蔞哷櫚慺膢藘謱簍勴葎褸梠櫨緑儢鋁侶録稆嵂膂縷偻絽驢閭繂慮屢榈寠垏呂褛綠闾捋缕侣虑滤履氯屡律旅驴铝吕绿率
la=揧鑞蝋藞翋柆楋臈鞡鬎溂臘蠟旯瘌菈砬邋垃落剌腊蜡辣喇拉啦
lai=鶆賚鯠庲誺箂藾娕睞淶錸籟徠崍頼癩騋棶崃萊瀨铼瀬唻賴涞籁赉徕癞睐濑來莱赖来
lan=鑭爦讕燗糷醂擥斕浨襤爁譋欗襴灡嚂躝暕纜籣闌灠欖嬾覽罱瀾壈攔濫覧儖欄漤籃灆諫褴攬婪嵐懶繿爛镧斓蘭藍谰榄缆阑澜览滥篮揽拦岚栏懒兰烂蓝
lang=朖欴筤桹鋃硠羮誏瑯稂蒗塱烺锒閬崀埌莨阆鎯螂郞榔啷琅廊朗郎浪狼
lao=嶗顟狫橯軂浶鮱嘮癆澇橑銠恅铹络蛯労荖潦僗簩耢撈栳鐒咾勞崂嫪醪落铑酪痨姥唠涝烙佬牢劳捞老
le=阞砳氻竻鰳鳓牞泐楽樂肋仂叻勒乐了
leng=踜薐睖堎崚稜塄棱愣楞冷
lei=頛禷壨瘣蠝礨櫐鸓轠虆讄瓃蘲蘱癗樏誄鐳礧塁縲絫蔂纇礌磥灅郲檑藟畾壘嫘罍儡缧鑸纍涙诔銇酹耒淚羸類擂肋镭勒垒嘞蕾磊泪雷累类
li=蒚鯬鸝塛鷅鱱竰鯏麜孷靂糎鵹筣糲鱺蠇藶轣犡鬁禲漦蚸峛礰靋欚壢蜧鑗邐鴗鱧蔾秝隷刕菞屴赲娳盭茘搮蠫廲岦癧跞讈癘櫪轢粴朸驪縭蠣蘺砅檪鋰樆礪灕謧犂扐孋濿醨鲡栃嚦瓥鯉栵剺瑮蒞苙瓅儮磿慄瀝轹篥涖籬劙蜊曆悷嫠厲浬釐隸儷粝歴厤黧歷勵猁暦悧疠鳢雳苈豊欐坜缡褵鬲蓠逦疬詈娌蛎枥栎唎曞醴鹂唳呖麗刂蠡罹禮溧俚琍莅離澧藜漓砾砺戾痢郦喱俪篱鲤璃傈狸隶骊锂笠裏荔裡俐犁励吏厘栗沥厉历梨莉粒哩礼黎例丽利立理力离李里
lia=倆俩
lian=嬚羷萰蹥鄻澰褳摙鰱覝瀲匳襝浰奩鰊磏鬑翴謰嗹錬薕歛璉聨漣僆蔹縺裣鎌裢槤憐簾鐮臁湅斂煉堜蠊聯練奁蓮鲢楝鍊潋戀臉殓镰殮鏈琏涟濂連敛廉怜帘炼链莲恋联脸练连
liao=飂嶚屪飉镽簝轑炓豂嵺蟟膋鷯蟧膫窌鄝尞窷摎憀嫽樛釕遼療敹繚鹩尥瞭钌鐐镣憭獠潦缭嘹蓼寥暸燎僚撂寮撩疗辽廖料聊了
liang=輬魎蜋啢綡鍄簗輌緉駺裲湸墚輛倞俍喨糧諒両踉悢涼魉樑靚椋兩粱谅晾俩粮靓辆凉良梁亮量两
lie=犣鮤擸猟茢蛚毟綟迾櫑颲埓鴷儠獵躐姴睙埒趔捩鬣洌冽劣猎裂烈咧列
lin=甐焛碄檁暽壣蹸翷顲橉藺隣轔懍躙惏鏻悋躪賃僯菻廩繗凜鱗潾瞵燐躏亃驎鄰箖疄辚嶙懔遴檩閵臨粼赁廪膦璘啉吝蔺凛鳞拎麟磷邻霖淋琳临林
ling=狑朎駖坽蘦昤婈砱裬櫺輘錂蔆欞鯪鴒醽爧詅琌皊齢軨姈笭霝蕶岺炩彾崚倰澪鲮霊淩齡嶺柃舲酃囹綾夌蛉鈴瓴領棂棱靈呤聆羚苓泠绫伶翎〇菱龄铃陵岭玲凌零灵领令另
liu=麍雡飂嬼磟蟉璢飀綹鷚塯藰裗嚠畄鎦鶹騮餾懰鰡廇澑霤罶栁鏐瀏嵧鹨珋媹锍蹓瑠镏蓅旒骝熘鎏馏绺劉碌浏榴琉遛陆硫瘤溜柳流六留刘
lo=咯
lou=髏鞻熡窶艛螻嶁耬塿瞜鏤瘺僂廔嵝髅摟偻婁嘍蝼耧蒌樓镂篓陋瘘娄搂露漏喽楼
long=篭嶐霳鏧靇豅蘢梇徿谾礱躘朧鸗蠬篢矓襱櫳嚨隴瓏巃哢鑨壟聾瀧蠪攏癃儱籠曨砻竜茏咙槞栊窿垅泷胧龍珑垄陇聋拢笼弄隆龙
lu=鵱膟鯥艣魲鸕蠦舮蹗塶籚玈罏淕勠蓾漊螰硉轤壚熝錴轆踛璷艪蔍艫磠氌瀘鏕鑪觻翏纑坴鱸挔淥臚顱賂廘擼睩滷鷺穋鹵盝醁琭摝濾僇籙騄菉彔櫓蘆轳枦虜簏擄鈩稑廬镥嚕栌六蕗辘胪爐祿簬辂舻氇甪魯鐪垆盧嚧陸鸬鏀錄鲈逯渌赂绿漉碌橹泸撸戮掳潞虏颅噜鹭庐麓卤芦璐禄鹿炉卢露鲁录陆路
luo=硌鵅玀剆攎騾腡鱳蓏鮥跞覶鸁詻臝攭邏儽礫皪犖籮峈纙駱茖絡脶欙猓鑼儸蘿漯荦瘰泺捋猡蠃镙欏鏍烙倮逻羅椤雒骡箩珞锣摞囉螺萝络骆裸咯洛落罗

gua=颳鴰颪詿括騧緺劀苽剮罣鸹诖掛栝胍褂剐呱寡卦刮瓜挂
guan=痯鱞鱹樌鸛爟毌悺蒄筦舘鑵錧悹閞摜瘝貫慣矜観盥涫鏆鳏纶瓘琯鹳館掼觀祼關倌莞棺贯惯罐冠灌馆观官关管
guang=炚烡欟茪銧珖撗俇垙侊広洸犷胱桄廣咣逛广光
gun=蔉璭鯀袞輥惃磙棞绲滾丨鲧衮辊棍滚
guai=罫枴柺掴恠夬拐怪乖
ga=尜夹钆旮轧尕尬伽咖嘎噶
gai=賌峐豥漑賅槪瓂戤葢荄祴鈣芥陔垓赅溉蓋該乢丐概钙盖改该
gan=漧灨盰尷玵骭筸凎笴稈贛簳紺澉玕旰桿詌泔皯坩尴疳趕矸酐橄绀幹擀淦秆咁柑乾苷竿赣杆肝赶敢感甘干
gang=疘堈犅堽筻棡釭槓綱扛鋼岡崗剛戆罡肛杠冈纲缸岗钢港刚
gao=鷎筶勂鋯鼛祰韟櫜縞槹皐誥槔檺髙睪藁槁缟睾杲诰篙羔郜锆镐皋糕膏稿告搞高
ge=騔鴐鞷杚鮯愅吤韐合觡鎘滒塥轕鴿仡鉻獦蛤袼閤虼佮盖擱搿哿謌滆箇颌纥骼彁鬲閣胳圪疙硌戓膈嗝舸镉鸽铬個革搁咯戈葛阁割隔哥歌格各个
gen=揯茛亘哏艮根跟
geng=鶊菮骾峺郠堩鯁賡緪挭浭畊亙綆颈绠赓鲠埂哽羹梗耕耿庚更
gei=給给
gou=句玽耉韝覯雊耇搆冓簼構鈎袧芶購鞲緱笱佝鉤溝姤遘缑岣彀觏枸篝诟媾夠垢苟构钩勾沟购狗够
gong=熕匑輁拲龔红鞏塨幊栱貢蚣珙觥肱宮躬汞巩贡恭拱龚弓攻功宫供公工共
gu=逧橭濲薣唃鮕硲瀔蛌錮鴣蓇啒嫴尳軱峠皷凅泒轂柧愲榾盬堌詁羖牿僱嘏鈷稒贾梏蠱鸪鲴鹘棝箛罟酤穀榖轱汩蛄觚锢诂痼罛顧鹄牯臌菰崮毂瞽咕呱钴辜箍蛊菇沽雇估姑固孤鼓骨谷顾古故股
guo=簂漍蔮慖褁嘓圀槨墎瘑摑猓鐹彉蜾崞惈馘菓幗埚淉涡聝聒粿呙帼蝈鍋椁虢囗國掴過裹锅郭果国过
gui=猤茥筀祪蛫禬鳺椢觤蟡氿撌厬槶劊匭閨庪摫媯帰袿詭軌瞡邽刽鳜亀劌宄槼湀槻庋姽垝龜規晷匦皈炅簋刿鲑歸佹桧櫃貴妫珪瑰诡癸闺圭轨跪硅柜龟规桂归鬼贵

kua=舿絓銙錁骻姱誇侉胯挎垮夸跨
kuan=髖梡窾寬寛髋宽款
kuang=砿筺昿絋軠軦貺懭鉱穬恇絖誆爌矌鑛丱鄺礦洭壙鵟狅纩誑纊況贶劻夼曠诓哐诳眶邝圹旷筐匡况框矿狂
kun=硱猑涃錕裍豤鯤菎騉稛臗鶤鰥梱壼綑晜阃髡悃睏崑焜閫褌醌锟鲲琨捆昆坤困
kuai=旝廥圦獪膾璯鄶澮鱠狯儈郐浍塊哙脍会蒯侩筷块快
ka=裃擖鉲胩垰咯佧咔咖喀卡
kai=鎎塏勓輆烗颽剴鎧愷闓鍇欬锎暟垲忾凱蒈剀锴慨揩铠開恺楷凯开
kan=轗栞衎檻墈崁莰顑矙竷嵌戡丬磡瞰龛槛阚勘堪刊侃坎砍看
kang=閌匟嫝鱇漮邟鏮犺囥摃闶钪伉鈧慷糠亢炕扛康抗
kao=稾薧銬攷洘犒栲铐尻拷烤考靠
ke=嶱翗嵑緙犐樖趷嵙萪薖騍毼磆搕堁濭鉿頦龕渇悈軻痾匼砢榼锞牁剋鈳蚵钶骒溘稞疴顆瞌岢敤峇課氪窠錒蝌缂颏轲髁坷嗑恪苛珂咳磕渴棵柯颗壳刻客科克课可
ken=錹掯墾龈懇裉恳垦啃肯
keng=硻銵牼誙阬鏗鍞脛铿吭坑
kei=勀剋尅
kou=簆鷇怐滱瞉摳釦冦彄芤筘眍蔻叩寇抠扣口
kong=錓硿鞚悾崆箜倥恐控孔空
ku=狜胐桍捁跍嚳瘔搰朏袴矻楛喾褲骷庫绔刳堀窟枯裤酷苦库哭
kuo=鬠韕霩葀鞹筈懖适濶拡萿蛞擴闊廓括阔扩
kui=頯藈鄈楑蘬鍷欳嬇鐀頄簣餽顝闚躨楏嘳頍蹞聵憒卼騤聧蕢饋跬刲煃暌隗窺匱櫆悝睽媿喟愦傀篑聩馗蝰潰虧蒉戣岿樻喹勹匮揆夔逵馈愧溃盔窥魁葵奎亏

hng=哼
hua=蘤鏵鷨硴澅魤諙摦驊繣吪杹譁崋搳螖嫿嘩砉槬椛糀劃埖錵畵猾樺铧嬅華畫話骅哗桦滑划华画化花话
huan=雈鰀瞣鯇肒攌羦闤瑍嚾豲繯鴅鍰犿荁豩峘瘓奐澴渙潅睆貆雚懽澣歓轘讙锾萑漶緩逭煥鲩驩喚圜擐缳環郇歡痪豢嬛洹獾鬟奂涣換宦寰浣桓焕唤缓幻欢患环还换
huang=鷬騜奛葟餭鎤楻趪堭炾鰉鐄衁榥諻艎熿兤獚穔媓巟鳇蟥汻謊晄喤皝癀滉崲怳偟遑隍愰鍠潢肓湟徨幌篁蝗惶黃璜磺簧恍凰谎煌荒慌皇晃黄
hun=鼲睧繉餛睯觨緄慁涽琿諢圂渾倱珲惛掍诨閽阍棔馄溷浑荤婚魂昏混
huai=蘹褱櫰蘾褢划懐壊懷壞徊踝槐淮怀坏
ha=铪虾蛤哈
hai=餀駴塰絯烸胲侅駭嗐醢骸氦嘿骇亥還孩咳嗨害海还
han=莟雗蜭梒鬫甝嵅鶾睅顄蜬涆駻鋡銲頷鋎魽蔊哻谽虷凾暵釬閈豃唅頇螒阚撖榦晥犴扞顸蚶邗颔鼾韓焓漢邯琀捍菡酣晗憾悍撼罕瀚憨旱翰焊函涵汉韩寒含喊汗
hang=頏絎蚢魧笐貥苀迒颃斻垳沆绗巷吭夯杭航行
hao=好号浩豪耗郝昊皓毫灏嚎蒿濠蚝號壕颢镐嗥薅貉鎬嚆滈淏灝皜皞澔顥蠔晧暠哠鄗譹籇薃昦竓鰝
he=麧齃鑉餲篕籺靏峆齕靍閡魺鶡紇寉煂渮覈龢澕熇熆盉鉌翯闔挌粭佫蚵姀吓敆纥郃啝鞨鶴盍賀楁訶貉曷劾翮犵菏阂嗬爀涸阖颌壑诃褐禾赫鹤荷贺盒核呵河合何喝和
hen=拫鞎痕狠恨很
heng=鵆胻鑅啈烆脝恆姮橫桁佷蘅珩亨衡恒哼横
hei=潶黒嗨嘿黑
hou=餱鱟鄇鯸茩翭鍭帿郈腄葔詬糇洉齁瘊垕堠逅篌骺鲎喉猴候吼侯後厚后
hong=宖篊焢羾黌耾輷鞃妅霟霐閎嚝軣鈜竤彋吰谼谹嗊玒訌渱灴汯澋澒浤鉷讧葒翃鋐愩魟蕻垬轟仜黉鍧鴻竑訇苰荭紘吽闳薨紅烘泓轰弘虹鸿哄洪宏红
hu=魱衚鶘婟蔰鶦嘝壷韄餬焀頀鶻昒昈螜歑媩曶鯱雽匢槴淲瀫抇楜鬍垀熩沍箎縎淈鰗淴鵠轷滸冱虖核粐冴鄠鹱岵醐縠枑猢嫮滬烀俿嫭鹕囫鹘乕綔觳唿戶壺戽戸護煳槲怙惚和鹄滹瓠葫蝴戏瑚笏浒许琥祜鍙斛扈弖寣唬弧狐壶糊忽护互乎沪呼虎湖户胡
huo=瀖眓趏檴沎穫癨騞矐嗀曤膕謋咊姡臛秮濩锪湱劐攉鑊吙漷捇蠖耠夥豰钬藿禍嚄貨鈥獲佸嚯镬灬和豁伙惑祸霍获火货活或
hui=檅藱餯隓鰴翽繢瞺楎檓譭暳芔蘳憓痐禈豗獩譿闠蔧噅烠薉潓圚螝橞譓毇硊篲顪翬燬輠嘒賄詼燴襘檜洃徻鐬槥薈撝恛彙誨暉穢缋徊諱佪蟪廻诙揮匯迴溃毀絵虺繪咴恵蛔隳輝桧麾洄珲恚拻彗茴贿喙荟囘诲烩恢讳晦秽卉蕙悔徽绘晖會挥毁慧惠汇辉灰回会

juan=錈絭裐菤臇淃鋑睠帣睊呟朘鵑羂雋罥锩絹鐫桊捲蠲鄄狷镌劵隽圈眷鹃涓绢倦娟捐卷
jue=戄蟨鈌嶡趹彏鱖镼貜瘚刔臄屩觼虳玃殌鴃玨譎爝芵鐍趉蕝駃觖钁憰絶鷢赽脚劂訣獗覚桷镢決矍噱橛傕玦抉絕蹶覺谲崛攫蕨噘廴亅嚼孓撅厥倔珏爵诀掘角决绝觉
jun碅蜠呁蚐袀桾鵘鵔蔨燇焌餕皸鮶晙皹莙埈皲儁麇畯箟龟駿寯鍕鈞捃軍浚竣珺隽筠峻骏钧郡菌俊君军均
ji=鯚塉橶鵋鷑穖鰿螏韲鱀襋畟耭鑇癪刉霵銡癠錤蘮檕轚庴痵懻鏶齏穊槉鰶瀱裚鱭禝嶯谻齌隮蘻簎堲鸄膌踖簊臮覘揤覬撠鮆觙蹐齎鞿覊蹟躋叝皀璣羇諔霽鶺塈枅覿虀蕀鷄穄徛諅驥泲漃飢薊薺羈繋惎湒暩旣誋妀蒺継饑犄嘰卽跽譏诘鲚磯茤緝潗彶蠀茍偮際忣岋跡蕺鶏姞墼吇荠罽岌虮伋革濟齑犱掎擊乩櫅輯芰績撃積漈勣洎芨擠喞剞劑瘠笄骑鐖给圾佶繼雞跻剤楫戢奇嵴麂咭其紀笈期殛觊銈赍級屐玑悸計亟鲫幾嵇缉稷極嫉機記羁偈丮系稽畿讥唧丌箕伎畸亼蓟彑矶髻旡棘汲绩藉骥戟霁饥脊妓寂叽冀际辑迹激疾祭忌肌济姬击技籍积己纪暨剂季挤计吉继基寄鸡极记集急既机几即级及
jia=麚鴶蛺檟玾鵊扴梜猳抸椵毠郟婽犌貑鋏頬糘耞莢鉀泇筴豭頰斝嘏蛱跏幏榎恝袈胛浃賈駕瘕價夾郏铗傢鎵笳戞岬镓戛伽枷荚葭珈痂稼颊茄迦钾驾贾嫁嘉夹佳甲架价假加家
jian=麉葌擶寋猏轞韉鰎虃鬋鹸釼糋鵳瑐螹襺藆鰹櫼蕑椷襉菺珔熞譾礛餞籛諓瀸縑劔瞷鋻緘戩戔劗鞬惤磵樫鹼艱繭湕踐墹浅鲣箋監賎澗瑊彅揀検挸劒剱鑒俴薦鹣洊楗倹殲趼毽濺艦瞼檢偂殱牮儉搛笕謇鑑減踺裥鞯撿缣堅枧姦漸鍵剣湔蒹谫戬囝犍繝賤鑳锏幵饯硷簡槛熸缄菅劍僭腱間蹇翦戋睑牋艰柬見笺践谏俭茧歼涧荐溅鉴碱奸拣舰监煎坚渐尖肩检箭简剪捡健贱减兼键剑件建间见
jiao=鱎鵤鷦纐嘄趭嬓穚鷮敿嶕譥樔蟭煍釂曒餃鮫鉸撟皭鵁摷憿膲珓爝轎挍簥嘂勦斠劋矯獥僥皦絞筊灚驕澆艽撹僬嬌憍膠敫峤噍挢鹪儌笅湫繳悎茭敎攪佼徼醮鐎侥腳鲛酵較滘校跤狡剿铰皎饺蛟姣蕉礁窖骄轿郊椒绞矫嚼缴搅浇觉娇焦胶角脚较教交叫
jiang=翞杢嵹袶顜韁螿膙橿醤奬謽强虹奨櫤畺槳糨漿傋絳薑礓醬茳弶豇耩殭洚蔣丬缰獎犟講桨绛匠疆僵將浆酱蒋姜降奖江讲将
jie=媎鶛榤巀蠽鞂鍻蝔畍踕鞊蛶鉣幯跲嵥昅頡价楶趌桝刧砎迼犗痎阂衱蝍楷袺妎癤狤岊楬耤褯滐訐鲒詰檞倢岕骱誡曁掲家崨階潔唶堺拮屆紒碣疥偈疖玠劼秸節傑讦蚧結桔卩诘羯颉睫芥诫桀喈孑尐竭湝藉嗟婕阶劫揭捷截介洁戒届皆杰结界街姐节解借接
jin=榗濜饉堻惍珒壗贐覲縉藎觔蓳璡嬧燼璶嚍搢巹侭紟笒儘僸祲廑菫赆寖溍賮卺馑枃謹煡殣晉錦勁荩妗僅緊瑨觐烬衿缙盡槿堇進矜襟噤巾瑾靳谨浸筋津晋禁锦斤劲今紧尽仅近金进
jing=鶁鵛剄璥頚竫麠竸桱獷幜婛痙涇憼穽鼱旍鶄逕橸汫劤浄鯨暻莖弳荊倞凈徑丼亰獍蟼頸経瀞競弪靓刭淨鏡儆驚憬痉腈肼阱粳迳靜兢胫經殑璟旌泾睛鲸婧菁荆茎劲径靖竞境颈警晶敬镜惊井京净景精竟静经
jiong=昋逈燛臩絅駉坰褧烱泂浻臦熲炅扃煚冏冂窘炯迥囧
jiu=鯦麔朻鬮廏廐柾揫杦慦氿廄萛糺韮勼殧鷲糾鬏鳩阄柩桕赳疚舊厩啾僦韭鹫臼咎灸鸠纠舅究玖揪救九旧久酒就
ju=鵴鋦郹蘜驧腒鶋焣陱躆耟欅梮痀蜛狊颶涺襷豦澽駶鶪蒟淗櫸犑駏壉湨屨娵犋蚷岨鵙懅匊椇擧虡踘车罝輂挙駒侷岠埧泃鋸俥挶詎粔鉅懼筥且踽醵枸崌秬窭龃洰鞫柜趄飓椈拠榉袓倶屦閰苣倨锔舉咀榘雎疽琚莒椐苴姖劇裾沮遽踞讵焗據掬钜狙炬拘驹桔橘惧鞠锯矩拒俱菊举聚剧巨具居句距局据

quan=韏駩巏楾縓虇齤犈椦鐉酄蠸輇瑔姾觠綣勧矔汱絟腃顴婘湶踡銓畎埢烇辁牶詮弮牷惓権圏棬巻鬈悛痊勸筌權颧绻佺诠犭铨蜷醛荃券拳犬泉劝圈权全
que=搉慤蚗躤礭碻硞毃蒛鵲殻塙愨礐闋闕埆確皵悫榷炔阕鹊瘸阙卻雀确缺却
qun=峮宭麕箘羣麇逡囷夋裙群
qi=鶈麡艩鶀霋甈蠐稘罊鵸軝踑魕玂頎隑岓鯕籏濝釮磧緀焏邔捿蟣魌肐磎鬾桼肵咠緕朞褄疧栔纃藄鬿鄿榿躩鼜鏚慼呇毄扢蚑愒缉芞竒諆觭璂蚚慽禨婍郪棊臍盵鰭懠僛迉訖敧憇淒噐鬐娸湆碕稽亟騹唭棨棲斉俟騏玘悽倛啓済攲湇芑埼跂豈萋綺屺蜞蟿荠気槭騎棄啟蹊碁旂碛蕲汔桤蛴祇忔萁掑葺齊綦芪欹憩颀讫嘁圻迄氣耆沏杞骐亓畦凄鳍歧脐麒岐乞栖崎柒淇祺砌祈泣契欺绮汽祁戚岂琦琪弃漆棋企旗启妻骑奇齐七器气期起其
qia=酠殎硈愘鮚鞐帢冾袷葜髂卡洽恰掐
qian=榩鰬攐鶼蜸攓騚鑓黚粁竏鐱籖馯雃顅篟騝蕁婜篏濳塹欿朁揃軡鑯韆岒繾歁櫏葥譴縴媊檶鰜棈唊鈐騫挳輤籤奷犍拑僉鉗岍揵椠刋汧肷傔槧銭鉛箞潛仱蒨掮謙靬慊愆淺缱嗛牽遷荨箝墘簽扦搴钤灊佥褰悭阡堑钎谴錢芡虔芊骞歉仟钳纤嵌黔遣茜乾谦铅倩潜迁牵浅欠签千前钱
qiao=郻頝踍髜趬幧釥躈礄鄡嘺雀嶠嫶犞譑缲磝鍬蕎摮誚荍帩蹺趫竅潐燋蹻磽譙繑鞒僑硗劁墽礉噭墝蟜翹诮殼憔喬橋峤荞壳橇锹愀峭谯跷悄樵鞘撬侨窍俏翘瞧乔巧敲桥
qiang=蘠熗錆椌羻艢蹡蹌羥謒戧鶬薔檣斨鏘鏹漒嬙繦墏瑲矼鎗牄锖繈襁墻嗆彊蜣跄嶈槍戕镪牆戗唴搶嫱樯锵炝強羟蔷羌呛腔墙枪抢强
qie=伽鯜藒愜蛪蛣踥疌癿篋慊朅椄倢厒洯竊趄鐑郄挈箧锲惬鍥緁怯茄窃妾切且
qin=肣雂坅嶜鳹鈙菣螼埐蚙鋟耹顉埁斳藽菳櫬澿嶔梫扲昑庈頜蘄唚瀙駸忴矜墐懃靲锓螓廑檎慬欽吣儭瘽寑寢撳笉揿溱芩親噙衾嗪擒芹覃禽寝侵沁钦勤琴秦亲
qing=擏葝硜廎樈郬掅碃渹靘鑋頃綮鲭淸蜻靑圊勍凊檠謦亲傾黥慶氫罄輕漀箐磬苘顷氰請擎氢卿倾晴庆青轻情清请
qiong=赹桏笻橩瞏憌藑惸蛬舼璚藭煢筇銎瓊跫窮蛩茕邛穹琼穷
qiu=鮂鶖盚龝鯄釚鰌蝵穐蠤蛷釓唒梂恘紌媝趥觓鞦蟗朹煪鰽巰虯觩鰍緧賕訄逎莍殏坵崷璆鼽絿捄蝤龟銶蚯赇犰巯俅毬湫萩鳅逑楸遒虬酋泅糗仇囚裘丘邱秋求球
qu=斪坥齲葋淭阹駈菃鱋鶌焌竘蠷髷鴝絇匤軥蟝刞抾匷躣郥籧鼁螶翵胠趍欋趜鐻麮浀駆苣跼鮈覷臞磲癯軀蠼驅敺麹鸲岖詘鼩彡趨蛐劬朐紶蕖氍呿灈脥诎佉袪嶇璩蘧闃阒迲麴黢觑區衢龋躯蛆瞿祛驱趣趋渠屈娶佢曲取区去

xuan=愃蔙萲矎鍹駽愋轋贙蝖蓒揈蜁讂咺昍獧媗琁琄懁諠昡嫙癬鐶晅鋗諼鞙蠉鉉衒縼痃袨狟絢璿碹揎翾镟妶县懸禤玹券鏇軒谖楦儇煖烜泫渲選瑄漩煊暄铉绚癣眩喧璇萱炫旋悬宣轩玄选
xue=狘瞲蒆疶燢斈艝袕嶨梋鷽澩岤泧怴觷樰膤鱈轌謔泬吷壆泶趐噱踅鳕谑學彐削靴穴薛雪血学
xun=臐迿燅燖蔒愻咰襑燻鱘揗矄撏栒壎紃攳璕焄塤灥鄩馴勛眴噚葷蟳噀荨纁郇薫燂侚勲詢潯獯遜峋窨濬勳訊曛醺訓尋恂珣鲟蕈埙徇浔殉浚洵汛驯巽荀询旬迅循逊巡勋薰熏训讯寻
xi=漇橲鼳鼰屖欯緆桸騽蜤蕮衋榽闟葈鵗釸螇怬騱蝷廗蒠蔇驨黖飁恄鰼豯爔琋鰓釳貕餼蹝獡雟熂鯑渓譆徆酅凞暿恓焟摡咥鄎蟢覤鈒鱚銑鬩綌霫嶍覡郋睎虩蓆謵巇縰燨赩憘犧潝徯肸戱狶觿蠵諰惁枲潟碏盻嶲纚忥愾氥犠礂俙鼷鸂巂璽憙瘜卌蓰裼扱谿瓕歙菥樨鑴穸禊阋晳槢傒舾煕蟋螅郤習饩戯欷襲葸呬隰粞錫蹊悕屣熺繫橀豨舄牺翕檄唏淅莔觋窸蜥醯莃郗晞僖皙細矽鎴媳戲浠铣匸晰茜熹羲徙嬉犀栖汐烯禧嘻腊熄隙硒玺奚析膝悉昔曦袭夕习稀惜席熙兮息锡溪希吸细係喜戏洗西系
xia=騢颬碬閜鏬舝鶷魻縖赮谺螛硤陜欱浹蕸笚謑鰕烚諕舺煆廈轄圷徦峽狹珨唬柙硖祫俠罅黠嚇鍜蝦梺芐昰狎瑕遐呷暇狭匣辖厦峡侠霞虾瞎吓夏下
xian=鼸鷳烍鷴搟攇糮娹贒韅櫶毨嘕闞鋧屳馦躚瀗蛝癇羬顈攕埳蘞莧纎杴錎胘褼槏澖釤奾襳鰔獫陥撊譣赻盷鶱蘚壏峴豏韱筧嫺廯涀珗譀姭尟蜆溓鏾猃誸孅姺禰繊忺銛啣秈幰僴玁灦慳僊餡娊堿諴銜燹羨晛禒尠仚絃俔綅僩筅洗伭顕綫莶憸纖獮佡睍鹇鹹彡鮮險氙蚿獻閑跹跣嫻鍌県粯憲険顯憪锨暹閒縣铣癎苋賢岘籼蚬霰痫藓現線祆舷涎酰冼羡纤见娴衔腺掀馅宪陷献弦咸险鲜限贤嫌显仙闲咁现县线先
xiao=鷍痚揱薂踃驍髐熽蠨虈郩蟂髇藃燆痟涍歊轇獢謞萷莦膮穘嗃恔恷謏窙縿嘵斅謼漻翛灱詨骹梟囂鴞嘐憢瀟譊綃睄橚毊呺啋洨効枵皛潚猇銷箾暁蛸嘯崤簫虓笹篠淆魈庨蕭曉咲傚哓哮绡嚣骁逍枭硝宵潇霄箫削筱啸效销孝消萧校肖晓笑小
xiang=鯗缿鱶晑鱌鬨忀饟膷鄕衖閧銗薌鐌曏驤纕襐萫廂啌饗蠁餉緗瓖郷珦姠嚮蟓鑲詳欀闀瓨鲞儴項響葙鄉庠芗降骧缃饷飨橡襄厢镶详享巷翔湘祥响箱乡项香相象像向想
xie=齂齘焎搚龤齥韰孈蝢嗋吤慀燲齛裌屓薢奊魼祄猲蠏恊垥觟熁襭擷躠觧屭褻灺僁揳嶰卨繲脇屧媟颉榍諧叶瑎滊愶澥脅蠍劦緳伳渫絜挾瀣協偰攜瀉薤廨獬躞鮭纈拹绁勰邂解契缬冩亵謝撷褉楔寫榭懈燮偕械谐胁蝎挟屑泄卸血泻歇蟹协携斜邪鞋谢些写
xin=阠礥愖鬵橝妡釁盺庍惞廞馫寻舋焮撢鋅枔镡杺噺潃炘囟伈鐔鈊衅忄莘忻歆昕薪锌芯辛鑫馨欣信心新
xing=蛵觲餳箵莕裄娙鋞坙鉶鈃巠騂瑆哘涬陘狌婞垶荥陉悻洐倖饧省侀興擤硎煋猩惺荇腥杏邢刑幸形兴醒姓星型性行
xiong=哅忷恟赨詗洶敻兇汹芎夐匈凶胸雄兄熊
xiu=糔鮴饈鵂螑臹苬樇鎀鏥櫹銝烋滫臭嚊鏽茠鸺繍珛髹繡馐庥綉貅脙脩琇咻岫朽宿溴锈嗅羞袖绣休秀修
xu=瞁烼沀揟晇蝑烅緖驉窢藚蓲欨鄦胊蚼殈訹頊漵稰縃楈魖幁蕦鑐喣諿壻暊緰珝聟旴昫詡冔嬃魆卹謳欻諝掝慉洫砉鬚糈湑勗姁噓侐醑銊敍溆垿続訏敘蓿浒歔繻酗緒續呴虛盱顼诩勖畜許須栩圩吁婿戌煦墟胥絮绪蓄叙嘘恤序旭续虚许徐须需

zhua=髽膼檛簻挝爪抓
zhuan=蟤腞鄟瑼篿甎恮鱄膞諯嫥縳塼譔饌剸瑑囀摶漙僝耑磚転専簨顓颛專啭賺馔轉篆撰传砖专赚转
zhuang=戆梉焋獞戇樁粧湷奘壯荘僮妝莊狀裝幢桩妆壮撞庄状装
zhun=綧宒旽訰稕甽諄忳屯窀啍埻迍凖谆準肫准
zhuai=捙跩拽
zha=齰齇齟樝譇蔖蚻抯鞢挿苲譗溠鰈觰鮓扠揷潳閘煠奓蜡箚喋挓皻喥詐軋剳劄霅囃齄哳偞蚱痄紮砟楂栅搾咤柞查醡鍘揸铡吒喳轧咋榨诈札眨乍闸渣扎炸
zhai=鉙簀粂厏骴捚檡駘嚌侧瘵斎債择哜齋砦翟寨斋债窄宅摘
zhan=鸇餰驙醆驏虥琖黵轏魙輚橏譧蛅譫襢薝桟嫸饘颭鱣欃輾跕綻詀氈盞搌鳽棧偡嶄嵁栴惉斬谵邅霑崭旃佔戰辗戦颤绽毡瞻栈湛盏蘸粘詹沾斩展战占站
zhang=遧瞕弡騿鱆墇慞粀鞝扙傽嫜賬脹暲粻仉帳漲鄣獐幛蟑瘴嶂張漳樟璋彰障丈胀仗杖账掌帐章长涨张
zhao=鳭駋菬狣釽鮡瑵嘲盄鉊釗旐妱皽笊啁詔箌垗鍣炤曌櫂趙爪棹沼钊肇诏召罩昭朝兆着招赵照找
zhe=矺馲聑鮿讋砓虴鷓謺輙蟅囁蟄轍謫鍺淛鹧嫬夂粍輒悊晢螫摂磔棏摺柘赭谪蜇锗蛰乇辄蔗褶辙喆這浙遮哲折者着这
zhen=黰蜄縥朾靕抮駗裖鈂竧辴薽榐澵鱵栚遉寊轃珎葴鬒籈敶鴆揕絼賑鍼桭塡碪眹枮誫紖溱軫眕挋槇謓縝沴侲袗楨紾瑱獉禎椹診畛瑧鎭偵稹貞姫針浈樼胗蓁潧缜鸩陣轸鎮砧眞鍖箴赈榛圳侦斟禛疹桢祯诊臻甄贞朕帧枕珍振震阵针镇真
zheng=掟塣埩猙聇浧脀糽眐篜錚撜炡鯖諍鉦埥媜鮏丁箏睜幀崢姃掙癥崝倀烝綪晸狰証钲氶爭證湞鄭诤拯凧峥怔筝铮睁蒸政征症争挣郑证整正
zhei=这
zhi=疐釞馽祑覟駤銴膱蹢汦衼躑瀄翐輊嬂蟙坁榰藢鶨蘵騭瓆扻樴狾隲懫螲鷙搘墆樲懥猘杝擳阤胑汥梔秪洷识鑕鴙嚔巵騺縶疻贄楖胵躓晊觶瓡蹛捗跱袟穉泜摨犆慹酈鳷淽櫛櫍銍恉栺幟礩貭轾緻軹蚔廌臷秖秷鋕椥擿觝氏歭滍軽臸稙謢偫紩瘈傂扺踬迣禔阯樀擲徴踯夛寘埴滯姪膣摯乿沚衹黹凪薙畤剬觯絷轵庤鸷蜘柣値鉄職骘胝亊厔製織質執誌摭忮挃贽蛭帙卮栉桎咫紙陟媞豸庢潪彘帜枳戠祉窒跖帋峙郅祗雉殖栀秩挚徵侄吱炙隻稚痔趾肢旨址酯掷芷滞痣织脂植执芝职汁枝止置质智致支志治纸制直知指值至只之
zhou=駎駲鵃徟騆菷銂鯞輖珘婤賙輈翢睭譸謅咮椆胕淍荮詶縐薵箒紂驟鈾喌盩僽啁甃冑侜紬呪碡繇皺軸籀晝妯酎週帚诌胄纣绉洀宙骤昼肘皱咒舟轴洲粥州周
zhong=鼨炂堹蝩忪妐鈆籦衶迚彸螤祌穜蔠緟舯尰狆腫螽衆煄伀柊鍾鐘夂塚眾終踵種锺盅衷冢肿终忠众仲钟重种中
zhu=麆壴鮢絑鱁篫樦泏蝫眝羜鴸馵嵀罜竚跦蠩孎茿磩藷蓫蠾莇尌陼跙鋳篴鸀跓祩墸斸藸砫芧袾櫫灟軴劯窋欘鉒銖貯柷属殶櫧蠋鑄矚誅囑築舳橥疰钃术槠瀦燭笁丶紵佇紸麈硃躅駐瘃註褚杼翥邾炷苎瞩侏茱潴铢諸伫箸蛀豬拄蛛嘱洙竺渚贮诛烛铸筑株逐柱诸助珠驻竹注煮著祝朱主猪住
zhuo=鵫蓔硺籗藋罬穛斮梲棳蠿鐲櫡蠗捔汋琸篧諑趠蝃謶椓灂斀蹠啅矠圴缴噣穱鷟斲禚诼浞濁彴剢晫涿著琢茁倬擢斫镯焯濯酌啄灼拙浊捉桌卓着
zhui=鑆轛膇鵻腏醀錣餟醊諈騅娷贅硾錐縋綴箠缒惴埀倕甀畷隹墜骓赘椎锥缀坠追

chua=欻
chuan=暷輲玔賗歂汌釧瑏踳舡遄荈氚巛钏椽舛傳喘串川船穿传
chuang=磢窓刱剏牀愴傸瘡摐闖幢創怆疮闯窗创床
chun=鯙鶞媋槆鰆瑃鶉萶杶漘惷犉蓴橁暙賰偆脣鹑蝽莼純椿淳醇蠢唇纯春
chuai=膗欼膪嘬搋啜揣踹
cha=紁艖蹅疀靫奼臿嗏喳垞馇査猹鍤锸侘偛楂衩刹嚓镲姹诧杈汊檫槎碴岔搽茬察叉插茶查差
chai=囆袃祡蠆喍儕釵瘥虿侪犲豺钗差柴拆
chan=鋓艬酁磛獑幝嚵囅滻簅懴梴繟纒壥蕆旵幨嵼灛産剷嬋骣鏟湹諂摲闡毚丳棎讒冁饞瀺懺摻辿巉襜蟬劖鋋瀍纏羼孱顫儳產廛单鑱禪躔潺蒇谄觇煘忏阐澶蟾搀谗婵蝉掺馋颤铲禅缠产
chang=鼚鱨鋿鯧琩裮淐膓椙蟐韔甞錩惝僘厰悵萇嚐鋹倘腸償暢鬯裳菖氅伥鲳廠阊徜猖嘗苌場嫦怅昶長敞倡娼偿畅肠尝昌场厂常唱长
chao=窲轈巐罺鄛眧漅巣弨怊鈔剿耖牊晁焯嘲绰钞巢潮抄吵朝炒超
che=莗烢撦硩硨迠尺砗偖徹坼掣車澈彻撤扯车
chen=齔麎樄揨賝鷐肜螴墋贂嚫磣莐諶茞煁諃踸蔯沈疢棽讖襯傖榇龀伧塵碜瞋谶忱抻陳谌郴宸嗔琛衬称辰臣尘晨沉趁陈
cheng=鏿饓竀溗騬浾赬筬蟶碀檉庱鋮峸騁棦珵铛荿掁橕牚懲珹郕酲澂枨宬柽裎琤撐脭偁瞠蛏誠悜埕塍棖铖稱骋惩逞盛丞秤澄橙承诚撑乘程呈城称成
chi=麶齝岻饎貾腟鵄翨鷘胣鉹瓻漦謘瞝蚇遫鴟遅痸淔攡抶荎妛鉓眵鶒踟瘈喫懘勅熾癡摛坻絺馳齒恥瘛歯傺褫黐媸魑啻遲茌鸱蚩呎篪笞湁饬墀哧侈豉匙螭嗤叱敕彳叺弛炽斥耻翅驰痴齿尺赤迟池持吃
chou=嬦懤躊燽雔杽杻讐殠帱絒菗綢犨吜篘讎疇栦籌瘳惆雠醜踌俦绸酬稠瞅畴筹仇愁臭丑抽
chong=憃浺隀罿珫銃茺艟种寵蹖蟲忡憧沖衝舂铳翀崇宠虫充重冲
chu=琡檚躕臅珿鄐幮蒭犓懨趎礎豖耡鶵斶鋤蒢篨歜蜍摴櫥雛貙廚芻觸憷敊齣絀儲儊搐滀躇俶樗绌濋蹰楮黜滁础刍矗怵處処亍橱杵锄雏畜褚厨储触楚初除处出
chuo=擉嚽齪逴惙輟娖歠綽磭踔龊辍啜绰戳
chui=菙鎚錘椎圌缍陲棰槌炊捶锤垂吹

shua=唰耍刷
shuan=閂闩涮拴栓
shuang=鷞縔灀艭慡礵漺驦樉孇塽滝泷孀雙霜双爽
shun=鬊瞚輴橓蕣楯順巛吮瞬舜顺
shuai=帥蟀率衰摔甩帅
sha=嗄樧翜蔱萐菨挲硰喢翣繌杉乷歃唼鯊箑铩剎紗濈裟霎猀唦殺痧鲨厦刹莎煞纱砂沙傻杀啥
shai=骰繺閷攦篩簁酾色曬筛晒
shan=狦饍覢髟騸杣謆蔪圸閊灗鱔訕譱襂赸穇痁猭贍攙陝剼柵埏羶姍煔墡舢晱掞繕単纔敾僤禅笘潸鐥鄯墠钐彡芟剡樿嬗刪閃睒蟮讪搧骟苫赡掸膻单跚缮鳝汕煽膳疝姗栅擅陕杉珊扇衫善闪删山
shang=恦蔏螪鬺蠰謪觴慯塲汤殤尙垧仩賞绱晌傷墒觞熵裳殇赏尚伤商上
shao=鮹袑蕱輎玿髾旓弰鞘焼筲卲艄潲紹蛸召杓燒苕劭芍捎韶梢哨勺绍邵稍烧少
she=騇慴挕輋檨蔎猞韘懾賒渉舎蠂揲涻捨厙滠闍厍設攝歙麝折畲慑赊赦奢佘涉舌摄舍蛇射社设
shen=籸鋠鯵祳曋峷覾鰺眒邥駪罧瞫讅氠葠詵抌愼鯓瀋紳訷堔滲槮侺棯綝淰嬸葚渖伔甡嫀椹幓蔘娠妽榊胂脤侁腎糁矧诜兟審鰰諗柛蜃呻莘屾哂燊绅珅参砷婶谂渗慎什审伸肾申甚身沈深神
sheng=鵿曻鼪橳澠譝焺呏貹乗渑鉎憴渻賸湦繩陞剰偗泩眚嵊枡乘甥勝昇聲牲聖笙晟绳剩圣盛胜升声省生
shi=烒嘘鶳揓餝襹竍榁鳲軾鎩篒溮鮖釃遾枾貰襫邿鼫絁鼭觢鈰葹鰤忯笶澨鰣鉽蝨榯恀釈飭湤蒔鍉遰溼咶酾祏簭贳諡鲥獅螫駛鲺炻蝕塒崼栻弒溡諟辻濕奭埘屍勢実忕褷殖寔釋蓍筮铈識莳適視豕試舐飾峙轼湜實師詩谥饣丗弑礻柿恃匙噬虱拭什矢蚀驶嗜侍誓狮逝似释時示拾仕尸适势屎始饰识失湿士氏视施实世史食诗师室十石试式市使事时是
shou=獣綬獸艏壽痩绶狩扌収熟授寿兽售守瘦首受手收
shu=鶐鵨鮛焂跾怷裋襩踈虪攄鏣軗襡竪鄃璹陎癙橾杸婌鉥疎糬贖朮樞綀潻毹摅腧豎疋鼡紓秫術殳沐輸沭菽屬纾倏丨樹黍塾氀蔬澍數書戍曙抒庶枢墅薯漱暑赎恕姝殊孰梳蜀俞竖述署疏束淑叔鼠舒术熟属输树数书
shuo=鎙爍碩蒴妁搠槊铄数烁朔硕說说
shui=

ruan=礝燸蝡瓀壖緛耎檽堧軟朊阮软
run=橍閠閏潤闰润
ran=珃髥袡呥熯姌蚺苒髯冉燃染然
rang=鬤爙躟穣獽懹壌勷蘘瀼譲禳穰攘瓤壤嚷讓让
rao=隢襓犪嬈橈遶擾饒荛繞娆桡扰饶绕
re=喏熱惹热
ren=鵀靱飪肕靭訒荵銋綛紉袵扨栠軔涊牣腍芢屻韌姙饪仭葚認衽轫纫荏亻稔妊紝仞刄壬韧刃仁认忍任人
reng=芿陾礽扔仍
ri=馹鈤日
rou=韖莥鶔髳鰇騥楺蝚輮媃煣宍葇禸粈鞣蹂糅鍒厹揉柔肉
rong=駥烿羢蠑氄髶榵峵茙穃爃嶸軵褣毧瀜絨媶鎔傇嫆狨栄瑢肜蝾榮冗嵘茸戎熔榕绒溶蓉融容荣
ru=鳰蒘杁鴽醹蕠縟獳颥鄏挐擩袽帤筎銣薷込媷曘嗕侞蓐缛铷溽洳嬬襦嚅蠕褥孺濡辱茹儒汝乳入如
ruo=嵶鰯鶸撋楉篛鄀蒻渃婼爇箬偌弱若
rui=繠蘂橤蕋桵兊銳枘汭蚋叡緌蕤芮蕊睿锐瑞

zuan=纉揝躦籫鑚篹纘躜缵欑鑽纂攥赚钻
zun=捘鷷銌鱒跧踆袸噂嶟繜瀳罇譐僎撙墫僔拵鳟鐏栫樽遵尊
za=襍雥鉔磼噈雑拶雜咂扎匝杂砸咋
zai=渽賳災載甾崽灾栽哉宰仔载再在
zan=酇饡禶寁噆臢囋蹔鏨賛讃糌鐕喒灒拶儹瓚暫贊偺趱錾昝瓒簪讚攒暂赞咱
zang=弉贓賍臓臟牂奘驵蔵髒赃臧葬藏脏
zao=竃趮喿蹧繰簉竈譟梍煰傮繅璅璪皁慥唣蚤棗躁凿皂噪藻枣灶燥糟澡遭造早
ze=蠌鸅滜襗捑庂稄樍賾嘖謮蘀択侧伬迮箦舴責擇厠幘昃崱帻赜咋澤沢啧仄則择责泽则
zen=囎譛譖谮怎
zeng=橧矰璔縡磳鄫曽繒锃罾贈缯増甑综憎赠增曾
zei=鯽蠈賊贼
zi=鯔齜鶅蓻紎齍輜穧矷鄑椔胏杍錙璾鼒觜眥薋胾貲鎡訿鈭緇澬漬玆栥諮秶芓胔姉釨沝锱剚粢嵫茈牸辎秭崰菑孳倳耔赀茲髭資呰龇谘孖笫滓鲻淄眦訾吱趑恣呲咨缁姊孜渍滋籽梓姿兹仔资紫自字子
zou=黀齱鯫騶媰棷菆郰緅齺棸搊掫楱鲰諏偢鄹鄒陬赱驺诹奏揍邹走
zong=熧朡猣稯翪鑁惾騣蓗蝬潀愡椶艐昮鬷錝縦蓯瘲豵摠嵕惣傯綜倧蹤総枞偬縱腙總鬃综粽棕踪纵宗总
zu=踤葅趲駔蒩靻怚鉐踿謯珇詛砠哫傶箤綷柤伹爼倅鉏伜菹镞诅崒鏃俎組卆卒阻祖族足租组
zuo=椊岝繓葄撮筰葃侳稓鈼蓙捽胙笮莋阼柞鑿怍酢凿嘬祚琢唑昨佐座左坐作做
zui=纗欈絊嶊祽璻鋷嗺嶵檌濢噿酨酔睟樶檇嫢晬厜脧嶉枠觜蕞咀醉罪嘴最

cuan=簒躥攛巑攅镩攢竄撺汆爨篡攒蹿窜
cun=刌籿蹲邨皴忖吋寸存村
ca=礸嚓礤拆擦
cai=縩跴埰寀棌綵偲婇採戝財睬裁材财彩采蔡踩猜菜才
can=嬠黲澯慙驂飡慚蠶黪燦憯孱骖參慘殘粲璨惭蚕灿参餐残惨
cang=凔嵢獊鑶欌臧艙伧滄蒼倉沧舱苍仓藏
cao=曺襙騲艚艸螬嶆漕嘈糙艹肏槽曹操草
ce=蓛萴惻廁冊測憡側恻厕策册侧测
cen=嵾梣参涔岑
ceng=驓嶒層噌蹭层曾
ci=茦皉鶿餈飺趀濨莿柌蛓跐朿庛絘嬨茈佌偨泚伺辭栨賜鹚佽糍詞差疵兹祠雌茨慈瓷磁赐辞刺词此次
cou=輳楱玼辏湊腠凑
cong=徖瞛瑽樅蟌藂鏦欉暰謥慒孮驄賨悤怱叢聡悰囪蔥苁枞従聰囱婃熜淙骢匆璁琮從丛聪葱从
cu=鼀踀踧觕麤顣麁酢憱瘯卒殂蔟徂猝蹴蹙簇醋促粗
cuo=髊嵳遳蓌蒫銼莝鹺醝瑳剒齹瘥脞剉棤嵯夎蹉鹾痤矬磋锉錯厝挫措搓撮错
cui=慛竁鏙翆忰磪膬焠凗膵墔漼榱衰毳悴瘁璀啐淬萃粹摧脆翠崔催

suan=痠筭匴狻蒜酸算
sun=薞猻槂搎鎨蕵喰潠蓀筍狲損飧孫榫荪隼笋损孙
sa=隡攃馺挲靸脎颯摋灑薩飒卅仨洒萨撒
sai=顋揌毢僿賽鳃腮噻塞赛
san=閐糝糂毿鏒鬖帴毵馓繖糁傘氵彡叁伞散三
sang=桒鎟顙磉褬颡喪搡嗓丧桑
sao=鱢氉慅鄵鐰掻髞缲騒矂懆溞鳋埽缫騷掃瘙臊搔嫂骚扫
se=飋轖鏼廧栜濏穡澁璱嗇譅鉍粣渋銫澀穑濇铯拺啬塞涩瑟色
sen=森
seng=鬙僧
si=鷥螄罳榹禗肂鉰蕼覗禠梩蕬蟴貄楒媤凘緦鼶泀駟竢柶飼廝颸儩虒蛳洍鸶缌澌咝偲価俬兕笥耜絲涘汜姒驷锶伺俟纟嘶厶厮泗食祀饲嗣巳肆撕私寺丝司似斯思四死
sou=騪颼颾獀鎪鄋欶餿擻櫢籔藪醙锼蒐捜嗾瞍飕螋溲擞廋薮嗽嗖馊叟艘搜
song=嵷蘴蜙憁棇駷慫硹漎鍶濍枩倯傱聳訟娀愯頌鬆鎹忪誦凇竦悚菘崧淞讼怂嵩耸诵颂松宋送
su=鱐榡鷫藗櫯蘓泝謖膆洬玊驌鋉穌囌縤蹜樕餗遡嫊憟摵棴粛觫傃肅缩訴蔌嗉甦簌涑僳谡稣愬愫窣蘇夙溯肃粟塑酥宿诉俗速苏素
suo=簔逤莏縒鎈魦趖溹簑靃鎍瑣摍嗩鮻唢葰睃縮桫挲傞嗍惢鎖羧蓑娑琐梭莎唆嗦缩索锁所
sui=鐆毸旞檖哸繸滖荾陏禭浽璲穟娞縗襚髄埣瀡賥粋砕繀倠繐脺歳綏荽誶谇尿鏸濉穂挼鐩眭燧邃歲隨祟隧雖睢夊绥髓隋穗碎遂虽随岁

yuan=邧鶢榬裫溒蒬榞黿鼘邍嬽肙蝝鋺獂葾騵蝯楥羱禐裷鴛薗夗輐櫞笎鳶謜寃駌渕轅灁鵷蜎杬蚖蒝悁湲媴縁惌薳眢鎱妧箢妴褑螈噮嫄淵棩橼圜員掾芫園圓鼋垸爰瑗願緣辕遠塬鸳鸢沅垣猿援渊冤媛怨苑缘袁圆愿院园员源原远元
yue=龥髺抈黦鸙焆禴蘥躒礿矱蚎鑠鋭臒鸑擽扚戉蛻爚櫟鉞軏趯嶽噦鈅躍籥粵箹钥悅閱刖龠閲哕樾説瀹約钺栎玥说乐阅跃粤悦岳曰约越月
yun=韗齫员阭縜霣鈗蝹眃溳蜵馧熉鄖橒抎荺惲畇馻鄆奫熅縕轀韞玧篔薀繧隕慍蕓妘紜頵餫殞醞緷涒狁澐褞蘊沄勻煇贇氳纭伝郓暈韻賱鋆氲媼郧運枟酝殒恽愠韫熨陨筠耘雲昀蕴匀允孕芸韵运云晕
ya=齖聐孲圠磍穵輵圔襾厊錏庌唖輅堐齾姶訝蕥鴉疋婭椏呾埡揠犽猰岈迓鐚厓砑睚玡鴨啞痖琊掗壓亜氬崕讶桠氩垭亞蚜轧衙伢劜圧鸦吖涯哑崖娅芽鸭押雅牙亚压丫呀
yan=鬳鳫麙愝姲鼴狿齞躽孍萒騴楌黤鶠樮黫軅鳱隒曮壧礹虤驠齴酀嬐敥篶噞爓莚猒抁觾贋橪薟錟阽烻黭揅珚鷰牪壛嵓焔湺鰋漹裺淊釅蝘贗閆挩嶮嵒溎喭扊渰媕黶魘匽郔燄豜唌碞鴈娮鴳殷臙棪讌鷃沇厳讞厴簷埏醼揜顩嵃巌椻灩巘儼姸諺醃甗椼嚥洝铅硯喦褗塩艶巖綖菴龑罨艷鼹弇兗驗厭偣讠菸縯豔餍剡唁偐崦硏験嚴彥嬮顔饜挻嬿赝鹽兖厣芫顏晻阏胭郾酽谳湮閹俨魇奄閻滟蜒谚恹煙偃腌筵円鄢琰阉檐堰焱砚衍淹嫣晏焰厌掩闫宴咽阎焉验雁彦妍延研艳炎颜沿岩盐燕严言演烟眼
yang=鉠攁胦鐊紻懩禓岟雵軮歍抰鸉珜鴦婸眻煬瘍瀁颺坱崸鍈姎瑒羕敭昜潒崵癢佒卬怏暘蛘烊揚炴鸯垟徉疡様陽養鍚泱樣鞅炀楊恙殃佯秧漾仰央氧痒扬洋羊阳养杨样
yao=柼餚宎筄烑袎眑苭鷕鷂驁軺鰩溔玅覞穾恌陶艞嗂銚噛摿顤曣靿蕘撽榚殀窰詏嶢约謡窔榣抭尭訞騕獟揺轺颻铫窯燿葯么祅謠疟鴢岆堯殽瑤窅遙珧薬媱搖崾猺愮偠繇徭喓鑰葽窈鳐傜藥侥鹞垚肴杳吆钥夭舀谣爻曜幺窑瑶遥尧邀耀摇妖姚腰咬药要
ye=擨歋抴饁鐷漜擛蠮瞱鵺擫鎑曄楪鍱嶪痷窫殕澲靨殗燁拽瓛埜緤謁枒堨倻暍鄴熀邪铘爺頁業揶靥邺腋葉谒咽掖曳噎晔烨椰冶爷液耶野夜业叶页也
yi=燡齸熪稦鷊嶬顊陭黳耛瓵玴礒鳦媐耴饐艤跠芅焲贀鷖鷾鯣肊鸃霬萓艗鐿釴隿嶧羠唈轙匇郼膉桋蛇醳衵迆襼蛦欥搤鏔冝賹檥藙檍瘱嗌恞羛螔燱檹銕阣蛜沶澺戺蘙槷鮨熤狋貤掜謻峓熈瘞圛囈醷跇詍縊譺嫛靾迻飴絏珆紲浂毉寱殔瑿豷螘椸繶黓柂箷詑鷁懌畩宧禕劮扡歖蓺釶輗杙軼暆帠釔嫕鶂繹壱詒觺訑洢謚曀踦靉酏袘帟苅驛敼枍銥垼栘伿匜仡亄曵鉯昳裛埶廙彜齮錡簃佁眙枻繄崺頤誼勩泆彛貽偯钀詣儗誃駅俋衪瀷扆斁訳蜴墿拸肄癔黟褘議舣顗浥洩寲痍侇劓鎰遺荑醫蟻藝佾熼殪憶瘗峄钇異億燚呓旖镒饴怿譯儀缢悒艾铱圯猗槸迤嶷誒埸晹薏臆挹噫镱苡诒刈绎義翳熠翌潩诣咿羿屹弌辷揖佚乂沂弈胰彝疫漪翊贻轶弋谊驿懿蚁邑役裔椅颐抑溢奕夷遗咦姨议倚忆毅疑壹尾怡移译翼艺异逸矣医益乙仪宜义衣依意伊亦易亿已以一
yin=齦烎蒑齗欭慇濦輑猌趛蔩酓霠歅朄酳苂霒檭螾鷣硍蘟駰讔荶梀圁蟫銦韾鈏凐檃飮憖堷殥嚚隠靷傿婬釿誾粌瘖垽諲裀癮廕闉夤絪犾湮禋蔭狺崟堙吲噾伒窨垔茚氤隱愔訢鄞夂霪喑飲陰湚銀蚓洇姻龈铟垠廴寅荫茵胤瘾吟殷淫隐尹饮阴印音银引因
ying=鶧矨軈鸚梬甇巆鱦罌藀朠賏蘡韹嚶鴬攍蠳珱癭濚廮旲甖碤蝧瀠礯鎣頴蝿瀴濴籯謍覮蛍塋攖褮譻罃熒韺摬滎嫈瀅潁霙縄瓔暎煐鶯縈纓螢瀯営偀蠅俓灐応荥嬰柍渶鷹桜媵撄營嘤櫻穎潆鹦罂蓥瑩贏瘿茔膺璎楹荧應颍郢萤嬴萦缨滢夃瀛莺蝇婴瑛樱莹映颖盈鹰迎营影硬英赢应
yo=喲唷哟
you=聈揂蒏蕕魷獶肬貁鄾秞浟怞嚘逌牰莤耰蚘怮銹庮麀訧迶苃槱泑蝣戭輶沋郵楢蝤峟銪狖懮纋櫌姷羑褎偤誘繇蚰莸憂斿莠猶鱿黝牖卣優遊铕蚴莜瀀宥猷祐侑尢鼬囿攸冘柚疣酉釉铀诱呦悠佑邮犹幼忧尤幽优右友游油由又有
yong=鯒郺鰫嵱塎悀滽慂醟鷛嫞愑禜廱揘癰嗈雝踴鄘筩澭喁鏞怺傭擁恿臃湧槦饔埇鳙傛踊詠灉墉噰邕痈壅镛慵俑甬佣蛹庸雍泳咏涌拥勇永用
yu=稶軉礖雓饇斔桙鮽鴪楰驈鳿鯲畭輍飫籅頨螸斞礜篽鰅齬貗歶蘌蒮噊蓹硢燰鄅澞蘛羭菸鵒鷸艅蟈稢欝蕷獝鋊蕍睮盓淢翑緎荢罭轝鸒蝺鋙鸆覦璵鱊穻藇汚鱮澦峿砡麌錥鴥戫齵隃隩爩嫗挧歈衧袬陓礇楡喩扜醧灪旟釪謣諛栯玗籲媮蓣兪杅歟娯谷紆喁丿寙萭薁魊馭貍癒蔚堬傴邘儥嶼僪崳瘉禦祤敔淯伛棫潏蝓獄俁燏蜮窬輿諭伃鬱貐唹悇漁預譽偊尉舁褕瘐臾窳噳饫遹揄堉矞堣圄龉閼繘慾嵎燠狳棜悆畬踰娛鈺箊雩俣閾妪圉纡餘湡竽鹬觎牏嵛楀鬻顒谀萸瑀禺阈語腴庾欤迂鹆熨盂彧魚驭聿愉谕吁芋妤舆亐隅屿瘀昱榆馀峪煜寓毓狱誉钰娱淤豫渔禹愚虞俞瑜裕郁喻渝逾育御與於予浴预愈域羽遇宇语余欲玉雨鱼于与

wa=溛膃瓲韈韎媧窐窊嗢窪漥襪腽唲佤娲洼袜蛙娃瓦挖哇
wai=瀤咼喎崴歪外
wan=捖抏忨睕鋄杤岏綩輓捥薍紈綰澫刓槾琓翫汍鄤倇頑関芄豌綄掔晩灣彎潫笂晼畹莞惋鍐婠蜿纨脘卍菀萬琬剜椀夘烷顽绾蔓皖宛挽腕婉丸弯湾碗晚完万玩
wang=瀇輞菵抂盳迋辋尪朢仼徃魍莣暀惘網罔枉妄亡旺汪望忘往王网
wen=鼤鳼榲饂鰮桽歾抆豱殟魰塭呅忞馼絻呡鰛穏瑥顐妏闅阌脕璺穩紋閿溫紊聞炆蕴芠閺玟亠刎問瘟汶搵蚊雯纹吻闻稳温文问
weng=塕瞈鶲罋暡齆螉奣聬蕹甕蓊滃嗡瓮翁
wei=葨腲饖隇斖揋瓗濻烓骫罻韙鰄椳躗潿巋犩癐瀢褽覣愄覹磈讆踓蜼峞渨蜲蝛鏏鄬椲犚詴芛磑縅喡藯媦峗霺餧鮪徫鮇癓蔿蘶濰趡衞諉碨蝟霨瞶溈蓶軎痏壝湋頠鮠洈煒蒍撱鲔葦廆儰崣僞韡菋餵違崴诿梶瑋幃緯遗涠艉煟韋濊猬噲浘韪沩偽溦闱鍡暐衛逶維隈嵬圍寪闈洧偉隗謂娓猥潍帏桅痿鍏葳圩帷囗偎煨爲萎渭尉巍违苇畏慰纬蔚玮炜危為惟谓尾伪薇韦围唯委卫胃魏威维伟微味喂位未为
wo=薶捰婐瞃捼濣婑撾焥猧萵蝸腛踒齷踠擭雘渦瓁涴仴莴濄窩堝龌挝臥幄偓斡肟蜗渥倭涡硪沃卧握窝喔我
wu=齀鴮釫鋘矹鶩鵐珸螐錻茣鵡逜甒恶雺岉鯃趶瞴杇鷡鎢窏蘁幠碔扤霿玝莁膴騖郚嵨剭墲旿廡啎塢鄔牾躌粅呉嫵靰迕俉鹉亡沕禑杌珷譕潕誣汙橆蕪倵洿阢嗚鋈憮務霧芴鼯烏痦浯堥誤圬洖怃於焐寤庑屼骛仵蜈鹜婺妩忤侮摀诬吳芜梧晤坞兀钨無邬戊毋呜污巫捂悟午务伍勿雾乌误屋武舞吾物吴唔五无

a=锕嗄腌呵吖阿啊
ai=餲溰鴱皚靄騃昹溾呆譪藹娭瞹璦啀锿曖礙敳砹鑀壒嬡薆僾欸毐嗌瑷噯嫒皑蔼捱霭隘嗳暧愛碍哀埃癌矮挨艾哎唉爱
an=鵪雸腤馣峖啽萻韽豻錌銨諳鮟荌揞广厂埯犴鹌侒儑盦垵闇唵桉谙铵黯胺庵氨鞍岸暗案安俺按
ang=醠骯昻肮盎昂
ao=艹柪蔜爊隞滶岰嶴扷镺鼇襖擙墺謷鰲聱芺奡廒鏖鏊璈奧懊媪骜遨翱螯岙鳌坳拗獒嗷袄敖凹傲澳熬奥

e=豟櫮鵈砨蕚蚅齶餩匎軶歞鶚鰐峉蝁鑩堊廅砐遻堮軛咢頞鵞譌諤睋鱷崿阨悪珴娾迗搹囮顎訛苊砵鵝噁锇欸鹗額阿垩餓婀涐轭皒惡枙鍔谔锷腭愕遏峩讹颚萼丨屙鳄噩峨扼蛾莪娥鄂鹅诶厄哦恶呃饿俄额
en=峎奀蒽摁唔嗯恩
eng=鞥
ei=诶
er=衈轜鮞駬鴯峏輀胹栮薾刵荋粫貮咡陑毦弐邇鉺佴鲕餌侕貳栭洏鸸爾铒珥洱兒弍迩饵贰耳尔儿二而

o=筽嚄喔噢哦
ou=腢慪吘熰漚甌鴎鷗蕅毆嘔櫙藲讴怄歐区鏂沤瓯耦殴鸥呕藕欧偶

hm=噷
ng=唔嗯
